1111111111111111111
1E1000001C100100001
101001H100101C10101
1H10000000000000101
1010010000100000001
10100000C00E00P0001
101001H000000100101
1010000000100000001
100001H010101010101
1111111111111111111