111111111111111111111
100000000000000000001
1000C0000000000000001
100111001110011110001
100000000E00000010001111111111111111111111
110001111001110001111111111111111111111111
100000000000000000001111111111111111111111
100111001110011110001111111111111111111111
1000000000000000000P1111111111111111111111
111111111111111111111111111111111111111111